.................................................#...#..................................................................................................................................................................................
.................................................#...#..................................................................................................................................................................................
.................................................#...#..................................................................................................................................................................................
.................................................#...#..................................................................................................................................................................................
.................................................#...#..................................................................................................................................................................................
.................................................#...#..................................................................................................................................................................................
.................................................#...#..................................................................................................................................................................................
..........................................^^.....#...#..................................................................................................................................................................................
..........................................##.....#####..................................................................................................................................................................................
.............#............................##......###...................................................................................................................................................................................
.............#..........................................................................................................................................................................................................................
.........#...#............^^...........#................................................................................................................................................................................................
.........#...#.......##########........#................................................................................................................................................................................................
S.....#^^#^^^#^^....^^^^^^^^^^^^^..#...#..##^^....^^^.......E...........................................................................................................................................................................
###########################################################################################.............................................................................................................................................
